Code	NameID	Modification
Ala	ala	-
Gly	gly	-
Leu	leu	-
Val	val	-
aThr/Thr	thr	-
Ser	ser	-
Ile/aIle	ile	-
Cys	cys	-
dhCys	cys	unk
Asn	asn	-
Pro	pro	-
Asp	asp	-
Gln	gln	-
Phe	phe	-
Lys	lys	-
dhAbu	abu	unk
Trp	trp	-
dh-Ala	ala	unk
Glu	glu	-
Arg	arg	-
Abu	abu	-
Tyr	tyr	-
Hpg	hpg	-
NMe-Val	val	MT
His	his	-
diOH-Bz	dhb	-
NMe-Thr	thr	MT
NMe-Leu	leu	MT
Dab	dab	-
NMe-Gly	gly	MT
Hiv	hiv	-
OH-Asp	asp	unk
NMe-Phe	phe	MT
bMe-Asp	asp	MT
bMe-Phe	phe	MT
Dhpg	dhpg	-
OH-Asn	asn	unk
Orn	orn	-
NMe-Cys	cys	MT
N2Me-Asn	asn	MT
Fo-OH-Orn	orn	unk
Met	met	-
bOH-Cl-Tyr	bht	unk
3OH-Leu	leu	unk
bAla	b-ala	-
bOH-Val	val	unk
bLys	b-lys	-
NMe-Hpr	pip	MT
4Me-Pro	pro	MT
Dpr	dpr	-
OH-Orn	orn	unk
Hpr	pip	-
aFo-Gly	gly	unk
bOH-Tyr	bht	-
NMe-Ser	ser	MT
NFo-Ala	ala	unk
NFo-Val	val	unk
4Me-Hva	HICA	-
Hse	hse	-
Ac-OH-Orn	orn	unk
NFo-Met	met	unk
4OH-Pro	pro	unk
NMe-aIle/NMe-Ile	ile	MT
NFo-Hpr	pip	unk
Hty	hty	-
NMe-Ala	ala	MT
diMe-Cys	cys	MT
Cap	cap	-
dh-Trp	trp	unk
NFo-Lys	lys	unk
3Me-Glu	glu	MT
Cl-Tyr	tyr	unk
NMe-Asn	asn	MT
3Me-Pro	pro	MT
NMe-OMe-Tyr	tyr	MT
OMe-Thr	thr	MT
N2Me-bOH-Asn	asn	MT+unk
3OH-Pro	pro	unk
Aad	aad	-
NMe-Hty	hty	MT
Pha	phe-ac	-
OH-His	his	unk
aMe-Cys	cys	MT
Cl-Hpg	hpg	unk
NAc-OH-Orn	orn	unk
NAc-Cys	cys	unk
Cl2-Pro	pro	unk
NMe-Tyr	tyr	MT
NFo-Ile	ile	unk
NMe-Hpg	hpg	MT
NMe-Bmt	bmt	MT
2Dh-Mabu	abu	MT+unk
4Cl-Thr	thr	unk
bOH-Gln	gln	unk
NAc-Ala	ala	unk
NdMe-Ala	ala	MT
bbMe2-O-Met	met	MT+unk
Cl2-Hpg	hpg	unk
bMe-Gln	gln	MT
bMe-Ile	ile	MT
NAc-Thr	thr	unk
NMe-NAc-Ile	ile	MT+unk
NAc-Leu	leu	unk
NAc-3OH-Leu	leu	unk
Valol	vol	-
Ac-Phe	phe	unk
NMe-OMe-Thr	thr	MT
NMe-Fo-OH-Orn	orn	MT+unk
NFo-Ser	ser	unk
OH-dHpg	hpg	unk
NMe-bMe-Leu/diMe-aIle	leu	MT
NFo-Cl-Tyr	tyr	unk
NAc-Ile	ile	unk
Kyn	kyn	-
NMe-Pro	pro	MT
NAc-bMe-Phe	phe	MT+unk
NFo-Leu	leu	unk
NFo-OH-Orn	orn	unk
CysA	cysa	-
OMe-Trp	trp	MT
NMe-Trp	trp	MT
NMe-OH-Orn	orn	MT+unk
bOH-NMe-Val	val	MT+unk
ph-Gly/Ph-Gly	phg	-
OH-dHpg	hpg	unk
Ac-Trp	trp	unk
NMe-Ph-Gly	phg	MT
bMe-Br-Phe	phe	MT+unk
NAc-Ac-OH-Orn	orn	unk
NAc-OH-Trp	trp	unk
Cl-NMe-Tyr	tyr	MT+unk
NFo-Arg	arg	unk
NMe-5OH-Cap	cap	MT+unk
NMe-bOMe-Tyr	tyr	MT
NMe-Cl-Trp	trp	MT+unk
Br-Phe	phe	unk
NOMe-Ac-Val	val	MT+unk
NMe-bOH-Cl-Tyr	bht	MT+unk
NFo-Cl-Hpg	hpg	unk
NMe-Glu	glu	MT
NAc-aFo-Gly	gly	unk
bO-Met	met	unk
b3Me-Glu	glu	MT
NAc-His	his	unk
NFo-Cl2-Hpg	hpg	unk
NFo-Hty	hty	unk
NMe-N2Me-bOH-Asn	asn	MT+unk
NMe-bMe-Ile	ile	MT
NFo-OMe-Asp	asp	MT+unk
NFo-diOH-Arg	arg	unk
3Me-Hty	hty	MT
NMe-3OH-Pro	pro	MT+unk
NAc-bMe-Asp	asp	MT+unk
NAc-OMe-Trp	trp	MT+unk
NAc-Aad	aad	unk
NMe-Cap	cap	MT
NFo-Fo-OH-Orn	orn	unk
NFo-Tyr	tyr	unk
NMe-3OH-Leu	leu	MT+unk
NAc-Cl-Ile	ile	unk
3Me-4Me-Gln	gln	MT
NMe-O2-Met	met	MT+unk
NAc-Bmt	bmt	unk
3OMe-Ala	ala	MT
NMe-4OH-Thr	thr	MT+unk
NAc-bOH-Gln	gln	unk
NMe-Cl-Trp	trp	MT+unk
NAc-Cl2-Pro	pro	unk
NMe-N2Me-Asn	asn	MT
NMe-bOH-Tyr	bht	MT+unk
NAc-Cl-Hpg	hpg	unk
NMe-bOMe-Asp	asp	MT
bbMe-NMe-Trp	trp	MT
NMe-3Me-4Me-Gln	gln	MT
b1Me-Trp	trp	MT
NAc-5Me-Pro	pro	MT+unk
Ac-Ser	ser	unk
NAc-Br-Phe	phe	unk
NMe-Met	met	MT
NAc-3Me-Phe	phe	MT+unk
NFo-Dpr	dpr	unk
NFo-Br-Trp	trp	unk
bMe-Asn	asn	MT
NMe-3Me-Pro	pro	MT
NAc-3Me-Hty	hty	MT+unk
NAc-O2-Met	met	unk
NFo-bOH-Tyr	bht	unk
NAc-Br-OH-Trp	trp	unk
NFo-Bmt	bmt	unk
NMe-Asp	asp	MT
bOH-Asn	asn	unk
bbMe-Asn	asn	MT
NFo-Cl2-Pro	pro	unk
NFo-3Me-Glu	glu	MT+unk
NMe-CysA	cysa	MT
O-Met	met	unk
NMe-4OH-Pro	pro	MT+unk
NFo-bOH-Br-Phe	phe	unk
NAc-Tyr	tyr	unk
NAc-bOH-Cl-Tyr	bht	unk
NAc-OH-His	his	unk
NAc-3OH-5Me-Pro	pro	MT+unk
NMe-Dpr	dpr	MT
NFo-bMe-Gln	gln	MT+unk
NFo-MeO-Glu	glu	MT+unk
NAc-Ser	ser	unk
bCl-Trp	trp	unk
NAc-3Me-Pro	pro	MT+unk
NMe-Gln	gln	MT
NFo-F-ph-Gly	phg	unk
NFo-His	his	unk
NAc-Gln	gln	unk
NFo-Gln	gln	unk
b3Me-Hty	hty	MT
OMe-Asp	asp	MT
bOMe-Tyr	tyr	MT
NMe-3Me-Hty	hty	MT
NAc-Glu	glu	unk
NAc-bOMe-Asp	asp	MT+unk
NFo-O-Met	met	unk
NFo-bOMe-Tyr	tyr	MT+unk
NMe-4Cl-Thr	thr	MT+unk
NFo-O2-Met	met	unk
NMe-dPhe	phe	MT+unk
NtMe-Leu	leu	MT
NFo-Cl-Trp	trp	unk
NFo-Dab	dab	unk
NAc-1Me-Trp	trp	MT+unk
MeO-Glu	glu	MT
NMe-bMe-Br-Phe	phe	MT+unk
b5OH-Cap	cap	unk
NFo-bOMe-Asp	asp	MT+unk
NMe-3Me-Glu	glu	MT
NAc-N2Me-Asn	asn	MT+unk
NMe-aFo-Gly	gly	MT+unk
b3Me-4Me-Gln	gln	MT
Cl3-NMe-dhLeu	leu	MT+unk
bO2-Met	met	unk
NFo-Thr	thr	unk
NMe-OH-Asp	asp	MT+unk
NMe-Cl2-Pro	pro	MT+unk
bOH-Br-Phe	phe	unk
NFo-3Me-Phe	phe	MT+unk
gOH-NMe-Val	val	MT+unk
NFo-Asn	asn	unk
NFo-OMe-Thr	thr	MT+unk
NFo-4Me-Pro	pro	MT+unk
NAc-4OH-Thr	thr	unk
NAc-bOH-Val	val	unk
NMe-Arg	arg	MT
NFo-Glu	glu	unk
bbNMe-NMe-Trp	trp	MT
NFo-bMe-Ile	ile	MT+unk
bbOH-Br-Phe	phe	unk
bOH-Asp	asp	unk
NMe-bMe-Asn	asn	MT
bOH-NMe-Phe	phe	MT+unk
NFo-Orn	orn	unk
NAc-Asp	asp	unk
NAc-OMe-Thr	thr	MT+unk
Cl2-NMe-dhLeu	leu	MT+unk
NMe-bMe-Asp	asp	MT
NFo-Phe	phe	unk
b3Me-Phe	phe	MT
bbOH-Cl-Tyr	bht	unk
NFo-1Me-Trp	trp	MT+unk
bbOH-Gln	gln	unk
NMe-5Me-Pro	pro	MT
NAc-Dhpg	dhpg	unk
NAc-Arg	arg	unk
NMe-OMe-Ile	ile	MT
bOH-His	his	unk
NMe-Cl-OH-Trp	trp	MT+unk
bbOMe-Asp	asp	MT
F-ph-Gly	phg	unk
NAc-O-Met	met	unk
NAc-Lys	lys	unk
baFo-Gly	gly	unk
bCl-Ile	ile	unk
NAc-4Me-Pro	pro	MT+unk
NFo-OH-Asp	asp	unk
O2-Met	met	unk
NAc-3Me-Glu	glu	MT+unk
Br-Tyr	tyr	unk
NFo-bbMe2-O-Met	met	MT+unk
NMe-OH-Ile	ile	MT+unk
NAc-bMe-Gln	gln	MT+unk
5OH-Cap	cap	unk
NAc-OH-Asp	asp	unk
NFo-Aad	aad	unk
NMe-Aad	aad	MT
NMe-Kyn	kyn	MT
NFo-3OH-5Me-Pro	pro	MT+unk
NAc-bbMe2-O-Met	met	MT+unk
NMe-Br-OH-Trp	trp	MT+unk
b4OH-Thr	thr	unk
NMe-bbMe2-O-Met	met	MT+unk
NAc-3Me-4Me-Gln	gln	MT+unk
NFo-OH-His	his	unk
NFo-Cl-Ile	ile	unk
NMe-diOH-Phe	phe	MT+unk
NFo-4OH-Thr	thr	unk
NFo-diOH-Phe	phe	unk
NdMe-Leu	leu	MT
NAc-Br-Tyr	tyr	unk
bOH-Orn	orn	unk
Cl3-2OH-NMe-Leu	leu	MT+unk
bbMe-Asp	asp	MT
NMe-Lys	lys	MT
NAc-Cap	cap	unk
NMe-Br-Trp	trp	MT+unk
NMe-Orn	orn	MT
NMe-Dhpg	dhpg	MT
NMe-Cl-Ile	ile	MT+unk
NMe-OH-His	his	MT+unk
NAc-F-ph-Gly	phg	unk
1Me-Trp	trp	MT
NFo-3Me-Hty	hty	MT+unk
NAc-Br-Trp	trp	unk
NFo-Ac-Ser	ser	unk
NFo-bMe-Phe	phe	MT+unk
NAc-Cl-Trp	trp	unk
NAc-bMe-Br-Phe	phe	MT+unk
NAc-Dpr	dpr	unk
NAc-bOMe-Tyr	tyr	MT+unk
NAc-Ac-Ser	ser	unk
NAc-N2Me-bOH-Asn	asn	MT+unk
diOH-Arg	arg	unk
Br-OH-Trp	trp	unk
3Me-Phe	phe	MT
NMe-Abu	abu	MT
NAc-4OH-Pro	pro	unk
3OH-5Me-Pro	pro	MT+unk
NMe-3OH-5Me-Pro	pro	MT+unk
NFo-OMe-Trp	trp	MT+unk
NAc-Hpr	pip	unk
b4Cl-Thr	thr	unk
NFo-bOH-Cl-Tyr	bht	unk
NFo-bOH-Val	val	unk
NFo-Dhpg	dhpg	unk
bN2Me-Asn	asn	MT
NMe-Br-Phe	phe	MT+unk
NFo-4Cl-Thr	thr	unk
bFo-OH-Orn	orn	unk
NFo-Kyn	kyn	unk
OH-bLys	b-lys	unk
Cl3-NMe-Leu	leu	MT+unk
NFo-CysA	cysa	unk
NAc-bMe-Asn	asn	MT+unk
NMe-bOH-Gln	gln	MT+unk
NAc-Cl2-Hpg	hpg	unk
NAc-Asn	asn	unk
NFo-bMe-Asn	asn	MT+unk
NAc-OH-Asn	asn	unk
NFo-Br-Phe	phe	unk
NFo-bMe-Asp	asp	MT+unk
NMe-Ac-OH-Orn	orn	MT+unk
Ac-Val	val	unk
NAc-bOH-Tyr	bht	unk
NFo-Br-Tyr	tyr	unk
NFo-N2Me-bOH-Asn	asn	MT+unk
NFo-OH-Asn	asn	unk
NMe-Br-Trp	trp	MT+unk
NFo-Cys	cys	unk
NFo-4OH-Pro	pro	unk
diOH-Phe	phe	unk
bbMe-Br-Phe	phe	MT+unk
bbMe-Phe	phe	MT
NFo-3OH-Pro	pro	unk
bbOMe-Tyr	tyr	MT
NMe-OH-Asn	asn	MT+unk
OH-Trp	trp	unk
NMe-1Me-Trp	trp	MT
bbMe-Gln	gln	MT
Br-NMe-Tyr	tyr	MT+unk
NMe-Cl-Hpg	hpg	MT+unk
bMeO-Glu	glu	MT
NMe-OH-Trp	trp	MT+unk
NFo-Pro	pro	unk
b3OH-Leu	leu	unk
NFo-N2Me-Asn	asn	MT+unk
NAc-Cl-Tyr	tyr	unk
bBr-Trp	trp	unk
NAc-Fo-OH-Orn	orn	unk
NAc-Orn	orn	unk
NAc-Abu	abu	unk
NMe-F-ph-Gly	phg	MT+unk
NMe-bOH-Br-Phe	phe	MT+unk
NAc-Ph-Gly	phg	unk
Br-Trp	trp	unk
NMe-OMe-Trp	trp	MT
Cl3-5OH-NMe-Leu	leu	MT+unk
NFo-Ac-OH-Orn	orn	unk
NFo-OH-Trp	trp	unk
NMe-Hse	hse	MT
NFo-aFo-Gly	gly	unk
NFo-3Me-4Me-Gln	gln	MT+unk
NMe-bAla	b-ala	MT
Bmt	bmt	-
Ival	iva	-
bBr-Tyr	tyr	unk
Me2-Bmt	bmt	MT
NAc-MeO-Glu	glu	MT+unk
NFo-Abu	abu	unk
NMe-O-Met	met	MT+unk
bCl-Tyr	tyr	unk
bAc-Ser	ser	unk
Ac-Pro	pro	unk
NFo-Hpg	hpg	unk
bdiOH-Phe	phe	unk
NAc-Hse	hse	unk
NAc-Kyn	kyn	unk
NMe-OMe-Asp	asp	MT
NFo-5OH-Cap	cap	unk
Cl2-NMe-Leu	leu	MT+unk
bAc-OH-Orn	orn	unk
bbOH-Tyr	bht	unk
NAc-5OH-Cap	cap	unk
NMe-MeO-Glu	glu	MT
bOMe-Thr	thr	MT
bBr-OH-Trp	trp	unk
NFo-Trp	trp	unk
NAc-bOH-Br-Phe	phe	unk
NMe-3Me-Phe	phe	MT
NFo-Ph-Gly	phg	unk
4OH-Thr	thr	unk
NAc-Dab	dab	unk
NFo-Br-OH-Trp	trp	unk
I-NMe-Tyr	tyr	MT+unk
bOH-Trp	trp	unk
NAc-OMe-Asp	asp	MT+unk
bN2Me-bOH-Asn	asn	MT+unk
NFo-3Me-Pro	pro	MT+unk
NAc-Hpg	hpg	unk
NAc-4Cl-Thr	thr	unk
Ac-Ival	iva	unk
NMe-Cl2-Hpg	hpg	MT+unk
NMe-bMe-Gln	gln	MT
bThr	thr	-
NFo-Asp	asp	unk
NMe-bMe-Phe	phe	MT
NFo-Cap	cap	unk
NAc-diOH-Arg	arg	unk
NAc-Met	met	unk
5Me-Pro	pro	MT
NMe-His	his	MT
NFo-bOH-Gln	gln	unk
NMe-4Me-Pro	pro	MT
NFo-3OH-Leu	leu	unk
NMe-Ac-Ser	ser	MT+unk
NAc-3OH-Pro	pro	unk
NMe-Dab	dab	MT
NFo-5Me-Pro	pro	MT+unk
NAc-diOH-Phe	phe	unk
bOMe-Asp	asp	MT
Cl-Ile	ile	unk
NFo-bMe-Br-Phe	phe	MT+unk
NAc-Hty	hty	unk
NMe-diOH-Arg	arg	MT+unk
bBr-Phe	phe	unk
Cl-Trp	trp	unk
NFo-Hse	hse	unk
bOMe-Trp	trp	MT
NAc-bMe-Ile	ile	MT+unk
bdiOH-Arg	arg	unk
NAc-CysA	cysa	unk
Aeo	aeo	-
NAc-Aeo	aeo	unk
NFo-Aeo	aeo	unk
NMe-Aeo	aeo	MT
3PAL	33p-l-ala	-
NAc-3PAL	33p-l-ala	unk
NFo-3PAL	33p-l-ala	unk
NMe-3PAL	33p-l-ala	MT
4PPro	4ppro	-
NAc-4PPro	4ppro	unk
NFo-4PPro	4ppro	unk
NMe-4PPro	4ppro	MT
Alaol	alaninol	-
Dht	dht	-
NAc-Dht	dht	unk
NFo-Dht	dht	unk
NMe-Dht	dht	MT
GlyA	glycolic-acid	-
Hyv	hyv	-
NAc-Hyv	hyv	unk
NFo-Hyv	hyv	unk
NMe-Hyv	hyv	MT
ICA	indole-3-carboxylic	-
LDAP	dpr	-
NAc-tCl-Leu	tcl	unk
NFo-tCl-Leu	tcl	unk
NMe-tCl-Leu	tcl	MT
tCl-Leu	tcl	-
Lyserg	lyserg	-
Oiv	2-oxo-isovaleric-acid	-
NAc-Piz	piperazic	unk
NFo-Piz	piperazic	unk
NMe-Piz	piperazic	MT
Piz	piperazic	-
Sal	sal	-